X 20 Y 23
X 20 Y 24
X 19 Y 24
X 18 Y 24
X 17 Y 24
