X 20 Y 26
X 19 Y 26
X 18 Y 26
X 17 Y 26
X 16 Y 26
X 15 Y 26
X 14 Y 26
X 13 Y 26
X 12 Y 26
X 11 Y 26
X 10 Y 26
X 9 Y 26
X 8 Y 26
X 7 Y 26
X 6 Y 26
X 5 Y 26
