X 10 Y 29
X 10 Y 28
X 10 Y 27
X 10 Y 26
X 10 Y 25
X 9 Y 25
X 8 Y 25
X 7 Y 25
