X 27 Y 5
X 27 Y 6
X 27 Y 7
X 27 Y 8
X 27 Y 9
X 27 Y 10
