X 20 Y 7
X 19 Y 7
X 18 Y 7
X 17 Y 7
X 16 Y 7
X 15 Y 7
X 14 Y 7
X 13 Y 7
X 12 Y 7
X 11 Y 7
X 10 Y 7
X 9 Y 7
X 8 Y 7
X 7 Y 7
X 6 Y 7
X 5 Y 7
X 4 Y 7
