X 20 Y 4
X 19 Y 4
X 18 Y 4
X 17 Y 4
X 16 Y 4
X 15 Y 4
X 15 Y 3
X 14 Y 3
X 14 Y 2
X 13 Y 2
X 12 Y 2
X 11 Y 2
X 10 Y 2
X 10 Y 3
X 9 Y 3
X 8 Y 3
X 7 Y 3
X 6 Y 3
X 5 Y 3
X 4 Y 3
