X 14 Y 1
X 14 Y 2
X 15 Y 2
X 16 Y 2
X 17 Y 2
X 18 Y 2
X 19 Y 2
X 20 Y 2
X 21 Y 2
X 22 Y 2
X 23 Y 2
X 24 Y 2
X 25 Y 2
X 26 Y 2
X 27 Y 2
X 28 Y 2
X 29 Y 2
X 30 Y 2
X 31 Y 2
X 32 Y 2
X 33 Y 2
X 34 Y 2
X 35 Y 2
