X 40 Y 9
X 39 Y 9
X 38 Y 9
X 37 Y 9
X 36 Y 9
X 35 Y 9
X 34 Y 9
