0000000000000000000011414111440000000000
0001431300000000000000111111400000000000
0004000100001000000000011134000000000000
00L300@000004410000000000000000000000000
00P4411110000000000000004000000000000000
00L1111440000000010000014110000000000000
00L0034111004000010004111111100000000000
4111111144141300111114311111131111333113
1141144410000000000031111114131111111411
00111311100000000000000000000000L0130L00
00000031110000000000140000004411P4413P41
00000000010000000000141100001114L4140L31
00000000000011311000311114111111L1111L44
00000000000141131110410130141111L1141L31
00000000410041111130100000000400L0000L00
1410000414411144411111000000111111044144
0000000000110000000000000000411111411131
004110000000L44111000000111L0300L1114L00
000430001011P00000000000010P3111P1114P31
000000311031L00000000000000L1141L0110L11
000000000011L00000000000000L1111L1441L11
00000000004300000000000000001141L3003L11
00000001001100000000001143101100L0000L00
1111001441441100113113131141113114001111
0000000000000000000011000000001100000000
0000000000001031110000L000000000L0401100
0000000000000000000011P011100011P0000000
0000000000000110100011L010000011L0000000
0003311100000000000034L000000011L0000000
0004000100001000000043000000001100100000
000000X00000411000004300000000130^101000
4114141444111111411114141103331131141314
BRANDON
CAVE
4
4
4
ARANDOMISEDLEVEL02
2


0