1411134113131411111000000000001444141111
343114001413113111400000@000000000000000
4144000000044010100000011100004400000013
144000000000000000000000400L001401404014
000000000000000000000443411P004144144141
000000000000000010000141141L001340310113
110000000000001140004111100L000100000004
4100000011111111414414111344114100000031
0000000000404134443111411141411300000000
000001140000L0314L00000000000000L0114000
011101110013P1114P11110000001111P0000000
000000000011L0443L31440000144411L0000000
000000000034L1114L14411113114411L0000000
031100000011L1011L1111000101114100010000
000000114100L0000L0000000000044101030000
0000000000141114131111000000344111343111
0000000000000000000014100014104111441444
0411111110041400111001100010001101114411
0041114100000000000000000000000000011141
0000000000000000000000000000000000000313
0000000000000001010031131114000000000000
0040000140000011000000000011000000000000
0441000141114413111100000000000000000011
4441411141111111113141111111114110000111
4441114444000000000000000000000000000000
1413004001000000000000L0000L000000000000
0000000000000000000000P1411P000000001000
0000000000000000000000L0000L000000000000
0000000000000414100000P4144P000000000000
0001100100001331110000L4141L000001111100
00030X1400114134411400L1441L000041141100
3444144141111411141113341441111141111411
BRANDON
CAVE
4
4
4
ARANDOMISEDLEVEL03
2


0