0000000000141110344000000000000000000000
0010113100000000001001144114100000000000
0000000000000000000000144113000440001110
0004101000000000000000000000000311000000
0044114000000000000000111411410000000000
0000000000000100040000000000000000000000
000000000000010@110000000000000000000000
4411411144141111114144111134114314141014
0000000000000001411100000000000000000000
0000000000011000000000L0000L000111411140
0001340000011100000000P1141P000014141100
0003100000000000000000L0000L000000000000
0000000000000000000000P4411P000000000440
0001011400000010000000L4344L000100004000
0000000100000010000000L1131L000114000000
1314140111111311411413114111141111141113
0000000000000010011100000000001131111331
0000000000000000011000000000000100311111
00000000L0000000000000000000000000000444
03114411P0000414000000000000000000000111
01011111L0000414000000111110000000000000
11000000L0000000000000111441103000000000
10000000L0111114414411113311410000000011
1411411441411111144414111411111110000014
4100000000000000000400000000110000000000
30L00111000041441L0000000000000411100100
11P00041000000000P1100041100110141400400
14L00000000000000L3400031100131131403100
44L00000000000000L140000000014000000010X
3400000000004000003400101000330431111114
1100000000001010001400^^43^0110011111411
1111010114441444441414114144114111111113
BRANDON
CAVE
4
4
4
NONE
2


0