1400000000114141441400000000000000000000
00L1010100110133041000000000000000000141
11P0000000000000000000000000000010000011
11L0000000000000000000000000000141100000
14L0000000000000000000141410000000011100
3100040000000000000004444131100000000100
1300014^000000110@0044441111440000000000
1411111341411443113114414411141000144441
0000000000000000000003130000000000000000
0000000000041100441001030001000000000000
0031000000000000000000000314000000000000
0114104140000141430000000000000000000000
0000000000000000000000000000000000000000
0000000000000000000000400001000000000100
001000000011131113140110004440401^040100
1111000111111111144111143111111134141111
0000000000000000000014000000001134443114
0000000000001110000030L00413000000000000
0000000000001000000044P00404001400000031
0000000000000000000041L00000001111040013
0031411100000000000041L00000001111144113
0111414110004111410011000000001111031131
0311141134000000010011000414003000000001
4113414111431131011314411144004300000014
0000000000000000000040111114111111114114
0111000100000000000000L1440L001110001414
0141100100000000000014P4444P113030000044
0141104300000000000013L1141L443440100041
000000040X000000000031L4113L313110000041
0113144111000000000011L1311L111110040414
0011411110000411000000L0000L000100000141
1111131411114414141314114114431110100111
BRANDON
CAVE
4
4
4
ARANDOMISEDLEVEL04
2


0