0000000000000000000000000000110000000000
000000000000401000000011311L000040111300
000000000000000000000000000P110000000000
00L0000@0000000000000000000L310001104000
00P111414000000000000000000L110013100000
00L4414110000001010000000000340004100000
00L0011144001000010000000000440000000000
1111113434141400411111401001441411111111
0000000000000000000014444131110000000000
0010404300000000000004411141440000011100
0000000000000000000011111134111110040000
0001101000000000000001414414104410000000
0000000000000000000004041111100000000000
0014140000000010000000000100000144000110
0000000000000144000000000000000000000010
1111341141434411113341434141110000000000
0000000000000000000000000000001000000001
0134000000000000000000000000001414001111
0031004340000000000000000000001110001111
0000000100000000000000000000000000000000
0000000000000314130000041410000010444000
0000000000004141110001114144001441413114
0300000100111141141041111311101111414111
3141003111341114141411133113111111111133
0000000000000000001111313141444441114113
0000000000000000000031411441140000000000
0000000000000110001413000000134100000011
0000000000000411004344400004414410004141
0000000000000000001341100001443111114111
0000000000000111101111100001144404001011
000X004100000000004413400001130000000004
4411413111133411111131114103313100000001
BRANDON
CAVE
4
4
4
ARANDOMISEDLEVEL05
2


0