0000000000000000000000000000000000000000
0000000000000000000000000000000000000000
0000000000000000000000000000000000000000
0000000000000000000000000000000000000000
0000000000000000000000000000000000000000
0000000000000000000000000000000000000000
0000000000000000000000000000000000000000
0000000000000000000000000000000000000000
0000000000000000000000000000000000000000
0000000000000000000000000000000000000000
0000000000000000000000000000000000000000
0000000000000000000000000000000000000000
0000000000000000000000000000000000000000
0000000000000000000000000000000000000000
0000000000000000000000000000000000000000
1111111100000000000000000000000000000000
0000000100000000000000000000000000000000
000*$$X100000000000000000000000000000000
0001111100000000000000000000000000000000
0001111100000000000000000000000000000000
0001111100000000000000000000000000000000
0001111100000000000000000000000000000000
0001111100000000000000000000000000000000
0001111100000000000000000000000000000000
0001111100000000000000000000000000000000
0001111100000000000000000000000000000000
0001111100000000000000000000000000000000
0001111100000000000000000000000000000000
0001111100000000000000000000000000000000
0001111100000000000000000000000000000000
0001111100000000000000000000000000000000
0@G1111100000000000000000000000000000000
DANIEL SCALES
CAVE
4
0
0
NONE
2


0