&000000000000&11111111111110000000000000
0000000000000011111111111110000000000000
0000000000000011111111111110000000000000
0000000000000011111111111110000000000000
0000000000000011111111111110000000000000
0000000000000011111111111110000000000000
0000000000000011111111111110000000000000
0000000000000011111111111110000000000000
0000000000000011111111111110000000000000
0000000000000011111111111110000000000000
0@00000000000011111111111110000000000000
1111110000000011111111111110000000000000
1111110000000011111111111110000000000000
1111110000000011111111111110000000000000
1111110000000011111111111110000000000000
1111110000000011111111111110000000000000
1111110000000011111111111110000000000000
1111110000000011111111111110000000000000
1111110000000011111111111110000000000000
1111110000000011111111111110000000000000
1111110000000011111111111110000000000000
1111110000000011111111111110000000000000
1111110000000011111111111110000000000000
1111110000000011111111111110000000000000
1111110000000011111111111110000000000000
1111110000000011111111111110000000000000
1111110000000011111111111110000000000000
1111110000000011111111111110000000000000
1111110000000011111111111110000000000000
111111^000000^11111111111110000000000000
1111111000000111111111111110000000000000
1111110h000h0X11111111111110000000000000
DANIEL SCALES
CAVE
1
0
0
NONE
2


0