0000000000000000000000000000000000000000
0000000000000000000000000000000000000000
0000000000000000000000000000000000000000
0000000000000000000000000000000000000000
0000000000000000000000000000000000000000
0000000000000000000000000000000000000000
0000000000000000000000000000000000000000
0000000000000000000000000000000000000000
0000000000000000000000000000000000000000
0000000000000000000000000000000000000000
0000000000000000000000000000000000000000
0000000000000000000000000000000000000000
0000000000000000000000000000000000000000
0000000000000000000000000000000000000000
0000000000000000000000000000000000000000
0000000000000000000000000000000000000000
0000000000000000000000000000000000000000
0000000000000000000000000000000000000000
0000000000000000000000000000000000000000
0000000000000000000000000000000000000000
0000000000000000000000000000000000000000
0000000000000000000000000000000000000000
0000000000000000000000000000000000000000
000000000000000000011111110000b000000000
0000000000000000000111111100000000000000
0000000000000000000111111100000000000000
0000000000000000000111111100000000000000
0000000000$*0.00*00$000$00$0@0$000000000
0000000$11111111111111111111111^^^^^^^^^
000$111111111111111111111111111111111111
0011111111111111111111111111111111111111
00000X1111111111111111111111111111111111
ANONYMOUS
CAVE
4
4
4
NONE
2


0