0000000000000000000000000000000000000000
0000000000000000000000000000000000000000
0000000000000000000000000000000000000000
0000000000000000000000000000000000000000
0000000000000000000000000000000000000000
0000000000000000000000000000000000000000
0000000000000000000000000000000000000000
0000000000000000000000000000000000000000
0000000000000000000000000000000000000000
0000000000000000000000000000000000000000
0000000000000000000000000000000000000000
0000000000000000000000000000000000000000
0000000000000000000000000000000000000000
0000000000000000000000000000000000000000
0000000000000000000000000000000000000000
0000000000000000000000000000000000000000
1111111111111111000000000000000000000000
1111111111111111000000000000000000000000
1111111111111111000000000000000000000000
1111111111111111000000000000000000000000
0000000000000001000000000000000000000000
0000000000000001000000000000000000000000
0000000000000001000000000000000000000000
*00000000000X001000000000000000000000000
1000000111111111000000000000000000000000
0000000111111111000000000000000000000000
000000$111111111000000000000000000000000
0000001111111111000000000000000000000000
*000000111111111000000000000000000000000
1000000111111111000000000000000000000000
0000000111111111000000000000000000000000
000@00J111111111000000000000000000000000
ANONYMOUS
CAVE
4
4
4
NONE
2


0