1111111111111111111111111111111111111111
1111111111111111111111111111111111111111
1111111111111111111111111111111111111111
1111111111111111111111111111111111111111
1111111111111111111111111111111111111111
1111111111111111111111111111111111111111
1111111111111111111111111111111111111111
1111111111111111111111111111111111111111
1111111111111111111111111111111111111111
1111111111111111111111111111111111111111
1111111111111111111111111111111111111111
1110000000000000000001111111111111111111
1110000000000000000001111111111111111111
1110000000000000000^01111111111111111111
1110000000000111100101111111111111111111
111&111111110111100001111111111111111111
sss0sssss11101111^00^1111111111111111111
sss0ssssss110$11110011111111111111111111
*0000******10111100001111111111111111111
1111111111110111100001111111111111111111
*000000111110$1110^00$111111111111111111
1111110111110111101001111111111111111111
1000000000000011100001111111111111111111
10000000000000*11000^1111111111111111111
10000^^^^0^^^^11$00011111111111111111111
1000011111111111100001111111111111111111
1000011111111111100^01111111111111111111
$0000$1111111111100101111111111111111111
1000011100000000000001111111111111111111
1000011100000000000001111111111111111111
1000011100000000000001111111111111111111
1*@0J111$$$X$$$$$$$$$1111111111111111111
ANONYMOUS
CAVE
4
4
4
NONE
2


0