0000000000000000000000000000000000000000
0000000000000000000000000000000000000000
0000000000000000000000000000000000000000
0000000000000000000000000000000000000000
0000000000000000000000000000000000000000
0000000000000000000000000000000000000000
0000000000000000000000000000000000000000
0000000000000000000000000000000000000000
0000000000000000000000000000000000000000
0000000000000000000000000000000000000000
0000000000000000000000000000000000000000
0000000000000000000000000000000000000000
0000000000000000000000000000000000000000
0002222222222222220000000000000000000000
0002111111111111120000000000000000000000
0002100000100000120000000000000000000000
0002100000100000120000000000000000000000
0002100000100000120000000000000000000000
0002100000100000120000000000000000000000
00021@(00010000X120000000000000000000000
0002111111111111120000000000000000000000
0002222222222222220000000000000000000000
0002222222222222220000000000000000000000
0002222222222222220000000000000000000000
0002222222222222220000000000000000000000
0000000000000000000000000000000000000000
0000000000000000000000000000000000000000
0000000000000000000000000000000000000000
0000000000000000000000000000000000000000
0000000000000000000000000000000000000000
0000000000000000000000000000000000000000
0000000000000000000000000000000000000000
ANONYMOUS
CAVE
4
4
4
NONE
2


0