011111111111111111111111111111:0100*0*0*
000000000000000011111111111111101P11P1P1
011111111111111011111111111111101L0*L*L*
00000000000000100***1111111111101L11L1L1
0111111111111P1011111111111111101L0*L*L*
0000000000101L1011111111111111101L11L1L1
111111111P1P1L1000000001111111101L0*L*L*
000000001L1L1L1011111101111111101L11L1L1
111011101L1L1L1*111111*0000000001L0*L*L*
11101R101L1L111111111111111111101L111111
11101P101L1L111111111111111111101L$$$101
11101L101L1L11##11000000000000001L111101
11101LP01L1L11##11RX0000000000001L$$$101
11101L100L0L111111111111111111111L111101
11101L11111L1111111111111#1#1#111L00110$
11101L10001L0&&&&&&&&&&&11111111111011P1
11101L10101110000000000000000000000000L$
11101L10101O1nnnnnnnnn1111P1111111111111
11101L101011111111111110B0L0000000111111
00000L0000000000000000001111111110000000
1111111111111111111111P0B00000001111111P
000$0$0$0$0000$0$101$1L$111P11100000000L
P1010101010111P1P101P1L11$0L0$1111111111
L1000000000111L1L0$1L1L$1P111P1$0000$10$
L1000000000111L1L1P1L1L11L1$1L1P1111111P
L1000000000111L1L1L$L1L$1L1P1L1L1$0$010L
L1000000000111L1111111L11L1L1L1L1P1P111L
L1^^^^^^^^^111L0000000L$1L1L1L1L1L1L000L
L111111111111111111111111L1L1L1L1L1L1111
L000000000000000000000000L0L0L0L0L1L000$
111111111101111111111111111111111L11111P
@00000000000000000000000000000000L00000L
DANIEL SCALES
CAVE
1
0
0
NONE
2


0