0000000000111000000000011111000000000000
0000000000111000000000011111000000000000
000000000011100000*010011111000000000000
$$@000000*111100111110011111000000000000
11110$(01111111P111000111111000000000111
111111101111100L111110111111000000011111
11111100000110$11111101111110000#0111111
1111111110000$11100000111000000011111111
10000111110$0111000001100000001111111111
10*.*00110011110000011100000011111111111
1111110000011110000000000000111111111111
111111111011111*000000000000011111111111
111111111011111110*000`00000011111111111
1111111111111111111111100000000011111111
1111111111111111111111111100000000111111
1111111111111111111111111111100000011111
1111111111111111111111111111100000001111
1111111111111111111111110000000000001111
1111111111111111111110000000000000000111
1111111111111111111000000000000000000111
1111111111111110000000000000000000000111
1111111111111000000000000000000000000111
1111111111111000000000000000000000000111
1111111111111000000000000000000000001111
1111111111110000000000000000000000001111
1111111111110000000000000000000000011111
1111111111100000000000000000000000011111
1111111111100000000000000000000000011111
1111111111000000000000000000000000^11111
111111111100000000000000000000^^^1111111
1111111111100000000000^00^^^^11111111111
111111111111100X0^^^^^111111111111111111
TEAM SPELUNKBOTS
CAVE
4
0
0
PUBLICTEST9
2


0