0000000000000000001B11111111000000000000
00000000000000000X110*111111000000000000
00000000000000001110*1111111000000000000
00000000**000000001B10011111000000000000
00000001111000000011B1011111000000000000
0000000011&00000000010*11111000000000000
0000000000000*r*00*10*B11111000000000000
000000000000111100B111111111000000000000
000000000000&1110011B0111111000000000000
00@0000000000000001110011111000000000000
1111111^^^^^^^^^^*1&0*j11111000000000000
1111111111111111111111111111000000000000
1111111111111111111111111111000000000000
1111111111111111111111111111000000000000
1111111111111111111111111111000000000000
1111111111111111111111111111000000000000
1111111111111111111111111111000000000000
1111111111111111111111111111000000000000
0000000000000000000000000000000000000000
0000000000000000000000000000000000000000
0000000000000000000000000000000000000000
0000000000000000000000000000000000000000
0000000000000000000000000000000000000000
0000000000000000000000000000000000000000
0000000000000000000000000000000000000000
0000000000000000000000000000000000000000
0000000000000000000000000000000000000000
0000000000000000000000000000000000000000
0000000000000000000000000000000000000000
0000000000000000000000000000000000000000
0000000000000000000000000000000000000000
0000000000000000000000000000000000000000
TEAM SPELUNKBOTS
CAVE
4
4
4
PUBLICTEST5
2


0