0000001111111111111111000000111000000000
000000111110000000000000000011100000000$
00000011110000000000000000001110000000X1
00@0000111000000000000000000111000001111
1111000111100000#00000000000111100011111
111000*11100011B11B1100000000111$0001111
00&0r0111000011111111000000001111$000011
*0B1111110*0010S000000000000011111$00011
10111111B11000000000000P10000111111$0001
10111111100000000000000L1000000011110000
1001111100000000000000^L1000000000000000
10000b000000000000000111>0000000000000*1
1000000000J0001000001B111000000000000011
1100n0n011100010000B111110000**000000<11
1111111111100010001111111001111110000111
11111111111100100*1111110000111100000001
1111111111110010011110000000000000000000
1111111111111010011000000000000000000000
1111111111111^1111^^^^^^^^^00^^^^^^^^^00
1111111111111111111111111111111111111111
1111111111111111111111111111111111111111
1111111111111111111111111111111111111111
1111111111111111111111111111111111111111
1111111111111111111111111111111111111111
1111111111111111111111111111111111111111
1111111111111111111111111111111111111111
1111111111111111111111111111111111111111
1111111111111111111111111111111111111111
1111111111111111111111111111111111111111
1111111111111111111111111111111111111111
1111111111111111111111111111111111111111
1111111111111111111111111111111111111111
TEAM SPELUNKBOTS
CAVE
4
4
4
NONE
2


0