1111111111100111111111111111111111111111
1111111100000b00000000000000000000000000
1111110000000000000000000000000000000000
11110b0000000000000000000000000000000@00
1111000000000000000000000000000000P11111
11*0*000000000k0n00000000000000000L11111
1111100000000011110000000000000000L11111
110000000*0*0B11111*j0000000000000L11111
11000000111111111111BP000000000000L11111
110000001111111111111L000000000000L11111
1000000000111111111b0L00nr0n000000L11111
1n00000000&0011b00000L011111110j00L11111
111100n000&000000n0111111111111111111111
1111111111110000111111111B11111111111111
111111111111110011111B111111111111111111
1111111111111100000111111111111111111111
000000000000B0000000b0000000000b00011111
0000000000001100000000000000000000000111
0000000000011100000000000000000000000011
11000#0001011100B1000001>0000000000000s1
11101110110111001100h0111100000000000001
1111111111000B0011P1111111110n0000000001
111111111111111000L111111111111111100001
1111111111111110011B11100000000110000001
11111111111111110111111X0000000000000011
11111111111111111111111111>0000*0000*111
1111111111111111111111111110*01110n11111
111111111111111111111111111^111111111111
1111111111111111111111111111111111111111
1111111111111111111111111111111111111111
1111111111111111111111111111111111111111
1111111111111111111111111111111111111111
TEAM SPELUNKBOTS
CAVE
4
4
4
PUBLICTEST8
2


0