1111111111111111111111111111111111111111
1111111111111000000000000000000000000000
1111111111111000000000000000000000000000
111111111111100000000000000000000000000@
1111111111111*X0*0000000000#0*0000000001
1111111111111111100000000P1111P000000P11
11111111111111111>0000000L0000L000000L11
1111111111111111111>00000L$$$$L000000L11
111111111111111111111P000P1111P000000L11
111111111111111111111L00$L1111L000000L11
111111111111111111111L0$111111L*^^*0*L11
111111111111111111111L011111111111111111
1111111111111111111111111111111111111111
1111111111111111111111111111111111111111
1111111111111111111111111111111111111111
1111111111111111111111111111111111111111
0000000000000000000000000000000000000000
0000000000000000000000000000000000000000
0000000000000000000000000000000000000000
0000000000000000000000000000000000000000
0000000000000000000000000000000000000000
0000000000000000000000000000000000000000
0000000000000000000000000000000000000000
0000000000000000000000000000000000000000
0000000000000000000000000000000000000000
0000000000000000000000000000000000000000
0000000000000000000000000000000000000000
0000000000000000000000000000000000000000
0000000000000000000000000000000000000000
0000000000000000000000000000000000000000
0000000000000000000000000000000000000000
0000000000000000000000000000000000000000
TEAM SPELUNKBOTS
CAVE
4
4
4
PUBLICTEST4
2


0