0000000011100000011111000000000000000000
0000000011100000011111000000000000000000
0000000011100000011111000000000000000000
.$@0000011100000*11111000000000000000000
111110*0111000*1111111000000000000000000
1111111$111$1111111111000000000000000000
1111111111111111111111000000000000000000
1111111111111111111111000000000000000000
1111111111111111111111000000000000000000
1111111011101111111111000000000000000000
1111100011100001111111000000000000000000
0000000011100000011111000000000000000000
0000000$111$0000011111000000000000000000
*X00*00111110*0#011111000000000000000000
1111110111100111111111000000000000000000
111111^^^^^^0111111111000000000000000000
1111111111111111111111000000000000000000
1111111111111111111111000000000000000000
1111111111111111111111000000000000000000
1111111111111111111111000000000000000000
0000000000000000000000000000000000000000
0000000000000000000000000000000000000000
0000000000000000000000000000000000000000
0000000000000000000000000000000000000000
0000000000000000000000000000000000000000
0000000000000000000000000000000000000000
0000000000000000000000000000000000000000
0000000000000000000000000000000000000000
0000000000000000000000000000000000000000
0000000000000000000000000000000000000000
0000000000000000000000000000000000000000
0000000000000000000000000000000000000000
TEAM SPELUNKBOTS
CAVE
4
4
4
PUBLICTEST7
2


0