0000000000000000001111110000000000000000
0000000000000000001111110000000000000000
00000000**000000001111110000000000000000
0000000$11$00000001111110000000000000000
000000$1111$0000001111110000000000000000
00000$111111$000001111110000000000000000
*#0@0111111110$$X*1111110000000000000000
1111111111111111111111110000000000000000
1111111111111111111111110000000000000000
1111111111111111111111110000000000000000
1111111111111111111111110000000000000000
1111111111111111111111110000000000000000
1111111111111111111111110000000000000000
1111111111111111111111110000000000000000
1111111111111111111111110000000000000000
1111111111111111111111110000000000000000
1111111111111111111111110000000000000000
0000000000000000000000000000000000000000
0000000000000000000000000000000000000000
0000000000000000000000000000000000000000
0000000000000000000000000000000000000000
0000000000000000000000000000000000000000
0000000000000000000000000000000000000000
0000000000000000000000000000000000000000
0000000000000000000000000000000000000000
0000000000000000000000000000000000000000
0000000000000000000000000000000000000000
0000000000000000000000000000000000000000
0000000000000000000000000000000000000000
0000000000000000000000000000000000000000
0000000000000000000000000000000000000000
0000000000000000000000000000000000000000
TEAM SPELUNKBOTS
CAVE
4
4
4
PUBLICTEST2
2


0