1111111111111111111111111111111111111111
1111111111111100000000000000000000000000
1111111111111100000000000000000000000000
11111111111110000000000000000000000*0@$$
1111111111110000000000000000000000011111
11111111111b0000000000000000000000011111
1111111111100000000000000000000000011111
1111111111100*n0*00000000000000000111111
111111111110011110000000000000000*111111
1111111111001111110000000000000001111111
1111111111001111110000000n000n0^11110000
111111111b000110b0000n011111111111100000
11111111100000000*$111111111111111000X00
111111111000000011110s01110s0111110011P0
11111111110000001000000000000000000*11L0
11111111111000000000000000000000000111L0
1111111111100000000011111111111000111110
111111111111$000000001111001100000b00100
1111111111111000000001000001000000000101
1111111111111$0$0$0000000*00000000$00001
111111111111111111110h*111110n0*01111111
1111111111111111111111111111111111111111
1111111111111111111111111111111111111111
1111111111111111111111111111111111111111
1111111111111111111111111111111111111111
1111111111111111111111111111111111111111
0000000000000000000000000000000000000000
0000000000000000000000000000000000000000
0000000000000000000000000000000000000000
0000000000000000000000000000000000000000
0000000000000000000000000000000000000000
0000000000000000000000000000000000000000
TEAM SPELUNKBOTS
CAVE
4
4
4
PUBLICTEST6
2


0