0000000000000000011111100000000000000000
0000000000000000011111100000000000000000
0000000000000000011111100000000000000000
0000000000000000011111100000000000000000
0*0*0@0*0*0X0*0*011111100000000000000000
1111111111111111111111100000000000000000
1111111111111111111111100000000000000000
1111111111111111111111100000000000000000
1111111111111111111111100000000000000000
1111111111111111111111100000000000000000
1111111111111111111111100000000000000000
1111111111111111111111100000000000000000
1111111111111111111111100000000000000000
1111111111111111111111100000000000000000
1111111111111111111111100000000000000000
1111111111111111111111100000000000000000
1111111111111111111111100000000000000000
1111111111111111111111100000000000000000
1111111111111111111111100000000000000000
0000000000000000000000000000000000000000
0000000000000000000000000000000000000000
0000000000000000000000000000000000000000
0000000000000000000000000000000000000000
0000000000000000000000000000000000000000
0000000000000000000000000000000000000000
0000000000000000000000000000000000000000
0000000000000000000000000000000000000000
0000000000000000000000000000000000000000
0000000000000000000000000000000000000000
0000000000000000000000000000000000000000
0000000000000000000000000000000000000000
0000000000000000000000000000000000000000
TEAM SPELUNKBOTS
CAVE
4
4
4
PUBLICTEST1
2


0