0000000000000000000000000000000000000000
0000000000000000000000000000000000000000
0000000000000000000000000000000000000000
0000000000000000000000000000000000000000
0000000000000000000000000000000000000000
0000000000000000000000000000000000000000
0000000000000000000000000000000000000000
0000000000000000000000000000000000000000
0000000000000000000000000000000000000000
0000000000000000000000000000000000000001
0000000000000000000000000000000000000001
1000000000000000000000000000000000000001
1000000000000000000000000000000000000001
1000000000000000000000000000000000000001
1000000000000000000000000000000000000001
1000000000000000000000000000000000000001
1X00000000000000000000000000000000000001
1100000000000000000000000000000000000001
1100000000000000000000000000000000000001
1100000000000000000000000000000000000001
1100000000000000000000000000000000000001
1100000000000000000000000000000000000001
11@000000#####00000000000000000000000001
1111111111111100000000000000000011111111
111111llllllllllllllllllllllllll11111111
111111iiiilllllllllllllllllllllllll11111
1111111111111111111111111111111111111111
0000000000000000000000000000000000000000
0000000000000000000000000000000000000000
0000000000000000000000000000000000000000
0000000000000000000000000000000000000000
0000000000000000000000000000000000000000
ANONYMOUS
CAVE
4
4
4
NONE
2


0