0000000000000000000000000000000000000000
0000000000000000000000000000000000000000
0000000000000000000000000000000000000000
0000000000000000000000000000000000000000
0000000000000000000000000000000000000000
0000000000000000000000000000000000000000
0000000000000000000000000000000000000000
0000000000000000000000000000000000000000
0000000000000000000000000000000000000000
0000000000000000000000000000000000000000
0000000000000000000000000000000000000000
0000000000000000000000000000000000000000
0000000000000000000000000000000000000000
0000000000000000000000000000000000000000
0000000000000000000000000000000000000000
0000000000000000000000000000000000000000
0000000000000000000000000000000000000000
1111111111111111111111111111111111111111
@0=00100000nnn010000bbbS0nnnS0ssss00nnn0
111101P111111101P11111111111111111111110
000001L100b0b001L1s$*bbbSSSSSS0Khnhhhhh0
011&11L101111111L1n111111111111111111111
0S00S0L100000000L1nnnnn0KhKhKhKhKhKhKS00
1111111111111111111111111111111111111110
bbbbbbbbbbbbbb001bbbbbbbbbbbbbb10ssssss0
000nnnnnnn00001P100000000000000101111111
000nnnnnnn00!11L10hhhhhhhhhhhhhh0nB00000
000nnnnnnn0!111L10hhhhhhhhhhhhh111111100
000nnnnnnn!1111L100000000000000100000000
***!!!!!!!11111L10sssssssssssss100000000
*********111111L101111111111111100001000
********1111111L000nnbbnnbbnnbbb000111!X
DANIEL SCALES
CAVE
8
0
0
NONE
2


0