0000000000000000000000000000000000000000
0000000000000000000000000000000000000000
0000000000000000000000000000000000000000
0000000000000000000000000000000000000000
0000000000000000000000000000000000000000
0000000000000000000000000000000000000000
0000000000000000000000000000000000000000
0000000000000000000000000000000000000000
0000000000000000000000000000000000000000
0000000000000000000000000000000000000000
0000000000000000000000000000000000000000
0000000000000000000000000000000000000000
0000000000000000000000000000000000000000
0000000000000000000000000000000000000000
0000000000000000000000000000000000000000
0000000000000000000000000000000000000000
0000000000000000000000000000000000000000
0000000000000000000000000000000000000000
00000000000000000000000000000000000000Y0
0000000000000000000000000000000000000000
0000000000000000000000000000000000000000
@0000000000000000h0000000000000bbbbbbbbb
1j=$j$j$00000000h$0$0$$$$$000000000$X0$0
11111111$000000h0111111111100Y0$11111111
111111111$00000$111111111111$00111111111
1111111111hhjhh1111111111111111111111111
1111111111111111111111111111111111111111
1111111111111111111111111111111111111111
1111111111111111111111111111111111111111
1111111111111111111111111111111111111111
1111111111111111111111111111111111111111
1111111111111111111111111111111111111111
ANONYMOUS
CAVE
4
4
4
NONE
2


0