0000000001111000000000000000000000000000
0000000001111000000000000000000000000000
0000000001111000000000000000000000000000
0000000001111000000000000000000000000000
0000000001111000000000000000000000000000
0000000001111000000000000000000000000000
0000000*01111777777000000000000000000000
0000111111111111111000000000000000000000
0000000000000000000000000000000000000000
0000000000000000000000000000000000000000
0000000000000000000000000000000000000000
0000000000000000000000000000000000000000
0000****00000000000000000000000000000000
0000111100000000000000000000000000000000
0000000000000000000000000000000000000000
*****00000000000000000000000000000000000
*****00000000000000000000000000000000000
000000000000000000000000000SSSSSSSS00000
0000000000000000000000000000000000000000
KhKKhhhh00hhh00000hh00h0000$$$$$$$$$$0X0
1111111111111111111111111111111111111111
111111111111$$$$$$$$$$$$$111111111111111
111111111111$$$$$$$$$$$$$111111111111111
111111111111$$$$$$$$$$$$$111111111111111
1111111111111111111111111111111111111111
1111111111110000000000000111111111111111
1111111111110000000000000111111111111111
111111111111$0$0$0$0$0$0$111111111111111
1111111111111111111111111111111111111111
0000000000010000000000000111111111111111
0000000000010000000000000111111111111111
70000@000?01$0$0$0$0$0$0$111111111111111
ANONYMOUS
CAVE
4
4
4
NONE
2


0