1111111111111111111111111111111111000000
1111111111111111111111111111111111000000
1111111111111111111111111111111111000000
1111111111111111111111111111111111000000
1111111111111111111111111111111111000000
1111111111111111111111111111111111000000
0000S000S000S001111111111111111111000000
0000&&00&&00&&00111111111111111111000000
0000000000000000011111111111111111000000
0000000000000000001111111111111111000000
.r00007000000000000111111111111111000000
11011111111111>0000<11111111111111000000
1*0*1111111111>0000<1700000B000000000000
11011111111111>0000<11110111011111111000
1*0*1111111111>5000050000000000111111000
11011111111111111111111111nnnnK711111000
1101100000000000000011111111111111111000
1101107000000000000011111111111111111000
1101101000000000000011111111111111111000
1101101000000000000010000000000000000000
1101101000000000000R1:*00*00*00*000000&0
RR0008170001P1111111111^^1^^1^^100000^0^
111111111111L111111111111111111111111111
111111111110LB0011111111111110#100000111
111111111111111P111111111111111100000111
111111000000001L111111$$$$110$1100000011
111111=$$$$$$$1L111111111111011100000111
111111111111111L11111111*011$$1100000111
000000000000000L111111011011111100000011
000000000000000L11111105101$$$1100000111
0@0000$00$$000*L111115011111111100X00111
1111^^1^^11^^111111111551111111111111111
ANONYMOUS
CAVE
4
4
4
NONE
2


0