0000000000000001111111100000000000000000
0000000000000601111111100000000000000000
*00@000000000B01111111100000000000000000
1111111>00&<1111111111100000000000000000
1111111*r00*1111111111100000000000000000
1111111110111111111111100000000000000000
11111111>0<11111111111100000000000000000
111111111&111111111111100000000000000000
11111110B*B00111111111100000000000000000
111111>01110<111111111100000000000000000
1111111011100111111111100000000000000000
11111000$0$00011111111100000000000000000
11111010<1>01011111111100000000000000000
11111j000000r011111111100000000000000000
1111111110111111111111100000000000000000
11111X*000<11111111111100000000000000000
1111111111111111111111100000000000000000
1111111111111111111111100000000000000000
1111111111111111111111100000000000000000
1111111111111111111111100000000000000000
1111111111111111111111100000000000000000
1111111111111111111111100000000000000000
1111111111111111111111100000000000000000
0000000000000000000000000000000000000000
0000000000000000000000000000000000000000
0000000000000000000000000000000000000000
0000000000000000000000000000000000000000
0000000000000000000000000000000000000000
0000000000000000000000000000000000000000
0000000000000000000000000000000000000000
0000000000000000000000000000000000000000
0000000000000000000000000000000000000000
DANIEL SCALES
CAVE
4
0
0
NONE
2


0