0000000000000000000000000000000000000000
0000000000000000000000000000000000000000
0000000000000000000000000000000000000000
0000000000000000000000000000000000000000
0000000000000000000000000000000000000000
0000000000000000000000000000000000000000
0000000000000000000000000000000000000000
0000000000000000000000000000000000000000
0000000000000000000000000000000000000000
0000000000000000000000000000000000000000
0000000000000000000000000000000000000000
0000000000000000000000000000000000000000
0000000000000000000000000000000000000000
0000000000000000000000000000000000000000
0000000000000000000000000000000000000000
0000000000000000000000000000000000000000
0000000000000000000000000000000000000000
0000000000000000000000000000000000000000
0000000000000000000000000000000000000000
0000000000000000000000000000000000000000
0000000000000000000000000000000000000000
000000000000000000000000000*************
0000000000000000000000000001111111111111
0000000000000000000000000001111111111111
0000000000000000000000000001111111111111
0000000000000000000000000001111111111111
0000000000000000000000000001111111111111
0000000000000000000000000001111111111111
000000000000000000000*000001111111111111
0000001000000000000001*00001111111111111
000001>00000000000000<1*0001111111111111
W0@0111^^^^^^^^^^^^^^1110X01111111111111
DANIEL SCALES
CAVE
1
0
0
NONE
2


0