0000000000000000000000000000100000000000
0000000000000000000000000000100000000000
0000000000000000000000000000100000000000
0000000000000000000000000000100000000000
0000000000000000000000000000100000000000
0000011100000000000000000100100000000000
0000011100000000000000001100100000000000
0000011100000000000000011100100000000000
000001110@00n000000001111100100000000000
0000011111111110000011111100100000000000
0000011111111111000111111100100000000000
0000011111111111101111111000100000000000
0000011111111111111111110000100000000000
000001X0000000n0000n0000n000100000000000
0000011111111111111111111111100000000000
0000000000000000000000000000000000000000
0000000000000000000000000000000000000000
0000000000000000000000000000000000000000
0000000000000000000000000000000000000000
0000000000000000000000000000000000000000
0000000000000000000000000000000000000000
0000000000000000000000000000000000000000
0000000000000000000000000000000000000000
0000000000000000000000000000000000000000
0000000000000000000000000000000000000000
0000000000000000000000000000000000000000
0000000000000000000000000000000000000000
0000000000000000000000000000000000000000
0000000000000000000000000000000000000000
0000000000000000000000000000000000000000
0000000000000000000000000000000000000000
0000000000000000000000000000000000000000
ANONYMOUS
CAVE
4
4
4
NONE
2


0