0000000000000000000000000000000000000000
0000000000000000000000000000000000000000
0000000000000000000000000000000000000000
0000000000000000000000000000000000000000
0000000000000000000000000000000000000000
0000000000000000000000000000000000000000
0000000000000000000000000000000000000000
0000000000000000000000000000000000000000
0000000000000000000000000000000000000000
0000000000000000000000000000000000000000
0000000000000000000000000000000000000000
0000000000000000111111111111100000000000
0000000000000000100000000000100000000000
00000000000000001lllllllllll100000000000
00000000000000001l111111111l111111110000
00000000000000001l100000001llllllll10000
00000000000000001l100000001llllllll10000
00000000000000001l1000000011111111l10000
00000000000000001l1@00000#000000X1l10000
00000000000000001l1110001111111111l10000
00000000000000001l111001111llllllll10000
00000000000000001l1$0011111l111111110000
0000000000000000111111111111100000000000
0000000000000000000000000000000000000000
0000000000000000000000000000000000000000
0000000000000000000000000000000000000000
0000000000000000000000000000000000000000
0000000000000000000000000000000000000000
0000000000000000000000000000000000000000
0000000000000000000000000000000000000000
0000000000000000000000000000000000000000
0000000000000000000000000000000000000000
ANONYMOUS
CAVE
4
4
4
NONE
2


0